#Station #Neighbour(line)
Acton Town	        Chiswick Park (District), South Ealing (Picadilly), Turnham Green (Picadilly), Ealing Common (District; Picadilly)
Aldgate		        Tower Hill (Circle; District), Liverpool Street (Metropolitan; Circle; District)
Aldgate East	    Tower Hill (District), Liverpool Street (HammersmithCity; Metropolitan), Whitechapel (District; HammersmithCity)
Alperton	        Sudbury Town (Picadilly), Park Royal (Picadilly)
Amersham	        Chalfont&Latimer (Metropolitan)
Angel		        Old Street (Northern), King's Cross St.Pancras(Northern)
Archway		        Highgate(Northern), Tufnell Park (Northern)
Arnos Grove	        Bounds Green (Picadilly), Southgate (Picadilly)
Arsenal		        Finsbury Park (Picadilly), Holloway Road (Picadilly)
Baker Street	    Regent's Park (Bakerloo), Marylebone(Bakerloo), Edgware Road(Circle;HammersmithCity), Finchley Road (Metropolitan), Great Portland Street(Metropolitan;Circle;HammersmithCity), St.John's Wood(Jubilee), Bond Street(Jubilee)
Balham		        Tooting Bec(Northern), Clapham South(Northern)
Bank		    Liverpool Street (Central), St.Paul's(Central), Old Street (Northern), London Bridge (Northern), Waterloo(Waterloo)
Barbican	        Moorgate(Circle;HammersmithCity;Metropolitan), Farringdon (Circle;HammersmithCity;Metrpolitan)
Barking		        East Ham (Disrtict;HammersmithCity), Upney(District)
Barkingside	        Newbury Park (Central), Fairlop(Central)
Barons Court	    Gloucester Road(Picadilly; Disrtict), Hammersmith(Disrtict;Picadilly)
Bayswater	        Paddington(Circle; District), Notting Hill Gate (Circle; Disrtict)
Becontree	        Dagenham Heathway(Disrtict), Upney(District)
Belsize Park	    Chalk Farm (Northern), Hampstead (Northern)
Bermondsey	        London Bridge(Jubilee), Canada Water(Jubilee)
Bethnal Green	    Liverpool Street(Central), Mile End(Central)
Blackfriars	        Mansion House(Circle; District), Temple(Circle; District)
Blackhorse Road	    Tottenham Hale(Victoria), Walthamstow Central(Victoria)
Bond Street	        Baker Street(Jubilee), Oxford Circus(Central), Marble Arch(Central), Green Park(Jubilee)
Borough		        Elephant & Castle(Northern), London Bridge(Northern)
Boston Manor	    Osterley(Picadilly), Northfields(Picadilly)
Bounds Green	    Arnos Grove(Picadilly), Wood Green(Picadilly)
Bow Road	        Bromley-by-Bow(District; HammersmithCity), Mile End(District; HammersmithCity)
Brent Cross	        Golders Green(Northern), Hendon Central(Northern)
Brixton		        Stockwell(Victoria)
Bromley-by-Bow	    Bow Road(District; HammersmithCity), West Ham(District; HammersmithCity)
Buckhurst Hill	    Loughton(Central), Woodford(Central)
Burnt Oak       	Edgware(Northern), Colindale(Northern)
Caledonian Road	    Holloway Road(Picadilly), King's Cross St.Pancras(Picadilly)
Camden Town	        Chalk Farm(Northern), Mornington Crescent(Northern), Kentish Town(Northern), King's Cross St.Pancras(Northern)
Canada Water	    Bermondsey(Jubilee), Canary Wharf(Jubilee)
Canary Wharf	    Canada Water(Jubilee), North Greenwich(Jubilee)
Canning Town	    West Ham (Jubilee), North Greenwich(Jubilee)
Cannon Street   	Monument(District; Circle), Mansion House(District; Circle)
Canons Park     	Stanmore(Jubilee), Queensbury(Jubilee)
Chalfont&Latimer   	Chorleywood(Metropolitan), Chesham(Metropolitan), Amersham(Metropolitan)
Chalk Farm	        Belsize Park(Northern), Camden Town(Northern)
Chancery Lane	    St.Paul's(Central), Holborn(Central)
Charing Cross	    Picadilly Circus(Bakerloo), Embankment(Northern; Bakerloo)
Chesham		        Chalfont&Latimer(Metropolitan)
Chigwell	        Roding Valley(Central), Grange Hill(Central)
Chiswick Park	    Ealing Common(District), Turnham Green(District)
Chorleywood	        Chalfont&Latimer(Metropolitan), Rickmansworth(Metropolitan)
Clapham Common	    Clapham South(Northen), Clapham North(Northern)
Clapham North	    Stockwell(Northern), Clapham Common(Northern)
Clapham South	    Clapham Common(Northern), Balham(Northern)
Cockfosters	        Oakwood(Picadilly)
Colindale	        Burnt Oak(Northern), Hendon Central(Northern)
Colliers Wood	    Tooting Broadway(Northern), South Wimbledon(Northern)
Covent Garden	    Holborn(Picadilly), Leicester Square(Picadilly)
Croxley		        Watford(Metropolitan), Moor Park(Metropolitan)
Dagenham East	    Elm Park(District), Dagenham Heathway(District)
Dagenham Heathway	Dagenham East(District), Becontree(District)
Debden		        Theydon Bois(Central), Loughton(Central)
Dollis Hill	        Willesden Green(Jubilee), Neasden(Jubilee)
Ealing Broadway	    West Acton(Central), North Ealing(Picadilly), Ealing Common(Picadilly; District)
Ealing Common	    Ealing Broadway(Picadilly; District), Acton Town(District; Picadilly)
Earl's Court	    KensingtonOlympia(District), West Kensington(District), South Kensington(District), West Brompton(District)
East Acton	        North Acton(Central), White City(Central)
East Finchley	    Finchley Central(Northern), Highgate(Northern)
East Ham 	        Barking(HammersmithCity; District), Upton Park(HammersmithCity; Disrtict)
East Putney	        Putney Bridge(District), Southfields(District)
Eastcote	        Ruislip Manor(Metropolitan; Picadilly), Rayners Lane(Metropolitan; Picadilly)
Edgware		        Burnt Oak(Northern)
Edgware Road	    Paddington(Circle;District; HammersmithCity; Bakerloo), Baker Street(Circle; HammersmithCity), Marylebone(Bakerloo)
Elephant & Castle	Lambeth North(Bakerloo), Kennington(Northern), Borough(Northern)
Elm Park	        Dagenham East(District), Hornchurch(District)
Embankment	        Charing Cross(Northern; Bakerloo), Waterloo(Northern; Bakerloo), Westminster(District; Circle), Temple(District; Circle)
Epping		        Theydon Bois(Central)
Euston		        Mornington Crescent(Northern), Warren Street(Northern; Victoria), King's Cross St.Pancras(Northern; Victoria)
Euston Square	    Great Portland Street(Metropolitan; Circle; HammersmithCity), King's Cross St.Pancras(Metropolitan; Circle; HammersmithCity)
Fairlop		        Hainault(Central), Barkingside(Central)
Farringdon	        King's Cross St.Pancras(Circle; Metropolitan; HammersmithCity), Barbican(Circle; Metropolitan; HammersmithCity)
Finchley Central	East Finchley(Northern), Mill Hill East(Northern), West Finchley(Northern)
Finchley Road	    West Hampstead(Jubilee), Swiss Cottage(Jubilee), Baker Street(Metropolitan), Wembley Park(Metropolitan)
Finsbury Park	    Manor House(Picadilly; Victoria), Arsenal(Picadilly), Seven Sisters(Victoria), Highbury&Islington(Victoria)
Fulham Broadway	    West Brompton(District), Parsons Green (District)
Gants Hill	        Redbridge(Central), Newbury Park(Central)
Gloucester Road	    South Kensington(Picadilly; District; Circle), High Street Kensington(Circle), Earl's Court(District; Picadilly)
Golders Green	    Hampstead(Northern), Brent Cross(Northern)
Goldhawk Road	    Shepherd's Bush Market (Circle; HammersmithCity), Hammersmith(Circle; HammersmithCity)
Goodge Street	    Warren Street(Northern), Tottenham Court Road(Northern)
Grange Hill		Chigwell(Central), Hainault(Central)
Great Portland Street	Baker Street(Circle; Metropolitan; HammersmithCity), Euston Square(Metropolitan; Circle; HammersmithCity)
Greenford	Perivale(Central), Northolt(Central)
Green Park	Bond Street(Jubilee), Westminster(Jubilee), Hyde Park Corner(Picadilly), Picadilly Circus(Picadilly), Oxford Circus(Victoria), Victoria(Victoria)
Gunnersbury	Kew Gardens(District), Stamford Brook(District)
Hainault	Fairlop(Central), Grange Hill(Central)
Hammersmith	Ravenscourt Park(District), Barons Court(District; Picadilly), Goldhawk Road(Circle; HammersmithCity), Turnham Green(Picadilly)
Hampstead	Golders Green(Northern), Belsize Park(Northern)
Hanger Lane	Perivale(Central), North Acton(Central)
Harlesden	Stonebridge Park(Bakerloo), Willesden Junction(Bakerloo)
Harrow&Wealdstone	Kenton(Bakerloo)
Harrow-on-the-Hill 		Northwick Park(Metropolitan), West Harrow(Metropolitan), North Harrow(Metropolitan)
Hatton Cross	Hounslow West(Picadilly), Heathrow(Picadilly)
Heathrow		Hatton Cross(Picadilly)
Hendon Central	Brent Cross(Northern), Colindale(Northern)
High Barnet		Totteridge&Whetstone(Northern)
Highbury&Islington	King's Cross St.Pancras(Victoria), Finsbury Park(Victoria)
Highgate	East Finchley(Northern), Archway(Northern)
High Street Kensington	Notting Hill Gate(District; Circle), Earl's Court(District), Gloucester Road(Circle)
Hillingdon	Uxbridge(Metropolitan; Picadilly), Ickenham(Metropolitan; Picadilly)
Holborn		Tottenham Court Road(Central), Chancery Lane(Central)
Holland Park	Shepherd's Bush(Central), Notting Hill Gate(Central)
Holloway Road	Arsenal(Picadilly), Caledonian Road(Picadilly)
Hornchurch	    Elm Park(District), Upminster Bridge(District)
Hounslow Central	Hounslow West(Picadilly), Hounslow East(Picadilly)
Hounslow East	Hounslow Central(Picadilly), Osterley(Picadilly)
Hounslow West	Hounslow Central(Picadilly), Hatton Cross(Picadilly)
Hyde Park Corner	Knightsbridge(Picadilly), Green Park(Picadilly)
Ickenham	Ruislip(Metropolitan; Picadilly), Hillingdon(Metropolitan; Picadilly)
Kennington	Waterloo(Northern), Elephant & Castle(Northern), Oval(Northern)
Kensal Green	Willesden Junction(Bakerloo), Queen's Park(Bakerloo)
KensingtonOlympia	Earl's Court(District)
Kentish Town	Tufnell Park(Northern), Camden Town(Northern)
Kenton		Harrow&Wealdstone(Bakerloo), South Kenton(Bakerloo)
Kew Gardens	Richmond(District), Gunnersbury(District)
Kilburn		Willesden Green(Jubilee), West Hampstead(Jubilee)
Kilburn Park	Queen's Park(Bakerloo), Maida Vale(Bakerloo)
Kingsbury	    Wembley Park(Jubilee), Queensbury(Jubilee)
King's Cross St.Pancras	Russell Square(Picadilly), Caledonian Road(Picadilly), Euston Square(Circle; Metropolitan; HammersmithCity), Farringdon(Circle; Metropolitan; HammersmithCity), Angel(Northern), Euston(Northern; Victoria), Highbury&Islington(Victoria)
Knightsbridge	Hyde Park Corner(Picadilly), South Kensington(Picadilly)
Ladbroke Grove	Latimer Road(Circle; HammersmithCity), Westbourne Park(Circle; HammersmithCity)
Lambeth North	Waterloo(Bakerloo), Elephant & Castle(Bakerloo)
Lancaster Gate	Queensway(Central), Marble Arch(Central)
Latimer Road	Wood Lane(Circle; HammersmithCity), Ladbroke Grove(Circle; HammersmithCity)
Leicester Square	Covent Garden(Picadilly), Picadilly Circus(Picadilly), Tottenham Court Road(Northern), Charing Cross(Northern)
Leyton		Leytonstone(Central), Stratford(Central)
Leytonstone	Leyton(Central), Snaresbrook(Central), Wanstead(Central)
Liverpool Street	Bank(Central), Aldgate(Metropolitan; Circle), Aldgate East(HammersmithCity), Moorgate(Circle; Metropolitan; HammersmithCity), Bethnal Green(Central)
London Bridge	Southwark(Jubilee), Bermondsey(Jubilee), Bank(Northern), Elephant & Castle(Northern)
Loughton	Buckhurst Hill(Central), Debden(Central)
Maida Vale	Kilburn Park(Bakerloo), Warwick Avenue(Bakerloo)
Manor House	Turnpike Lane(Picadilly), Finsbury Park(Picadilly)
Mansion House	Cannon Street(District; Circle), Blackfriars(District; Circle)
Marble Arch	    Lancaster Gate(Central), Bond Street(Central)
Marylebone	Edgware Road(Bakerloo), Baker Street(Bakerloo)
Mile End	Bow Road(HammersmithCity; District), Stepney Green(District; HammersmithCity), Bethnal Green(Central), Stratford(Central)
Mill Hill East	    Finchley Central(Northern)
Monument	Cannon Street(District; Circle), Tower Hill(District; Circle)
Moorgate	Liverpool Street(Metropolitan; Circle; HammersmithCity), Barbican(Metropolitan; Circle; HammersmithCity), Old Street(Northern), Bank(Northern)
Moor Park	Rickmansworth(Metropolitan), Croxley(Metropolitan), Northwood(Metropolitan)
Morden		South Wimbledon(Northern)
Mornington Crescent		Euston(Northern), Camden Town(Northern)
Neasden		Dollis Hill(Jubilee), Wembley Park(Jubilee)
Newbury Park	Gants Hill(Central), Barkingside(Central)
North Acton	East Acton(Central), West Acton(Central), Hanger Lane(Central)
Northwood		Northwood Hills(Metropolitan), Moor Park(Metropolitan)
Northwood Hills		Pinner(Metropolitan), Northwood(Metropolitan)
East Acton	North Acton(Central), White City(Centra)
West Acton	North Acton(Central), Ealing Broadway(Central)
North Ealing	Park Royal(Picadilly), Ealing Common(Picadilly)
North Greenwich	Canary Wharf(Jubilee), Canning Town(Jubilee)
North Harrow	Pinner(Metropolitan), Harrow-on-the-Hill(Metropolitan)
North Wembley	Wembley Central(Bakerloo), South Kenton(Bakerloo)
Northfields	South Ealing(Picadilly), Boston Manor(Picadilly)
Northolt	South Ruislip(Central), Greenford(Central)
Northwick Park	Preston Road(Metropolitan), Harrow-on-the-Hill(Metropolitan)
Northwood	Northwood Hills(Metropolitan), Moor Park(Metropolitan)
Northwood Hills	        Northwood(Metropolitan), Pinner(Metropolitan)
Notting Hill Gate	Holland Park(Central), Queensway(Central), High Street Kensington(Circle; District), Bayswater(Circle; District)
Oakwood		Cockfosters(Picadilly), Southgate(Picadilly)
Old Street	Moorgate(Northern), Angel(Northern)
Osterley	Boston Manor(Picadilly), Hounslow East(Picadilly)
Oval		Kennington(Northern), Stockwell(Northern)
Oxford Circus	Picadilly Circus(Bakerloo), Regent's Park(Bakerloo), Tottenham Court Road(Central), Bond Street(Central), Green Park(Victoria), Warren Street(Victoria)
Paddington	Edgware Road(Circle; District; Bakerloo; HammersmithCity), Bayswater(Circle; District), Warwick Avenue(Bakerloo)
Park Royal	North Ealing(Picadilly), Alperton(Picadilly)
Parsons Green	Fulham Broadway(District), Putney Bridge(District)
Perivale	Greenford(Central), Hanger Lane(Central)
Picadilly Circus	Oxford Circus(Bakerloo), Charing Cross(Bakerloo), Green Park(Picadilly), Leicester Square(Picadilly)
Pimlico		Victoria(Victoria), Vauxhall(Victoria)
Pinner		Northwood Hills(Metropolitan), North Harrow(Metropolitan)
Plaistow	Upton Park(HammersmithCity; District), East Ham (HammersmithCity; District)
Preston Road	Northwick Park(Metropolitan), Wembley Park(Metropolitan)
Putney Bridge	Parsons Green(District), East Putney(District)
Queen's Park	Kensal Green(Bakerloo), Kilburn Park(Bakerloo)
Queensbury	Canons Park(Jubilee), Kingsbury(Jubilee)
Queensway	Notting Hill Gate(Central), Lancaster Gate(Central)
Ravenscourt Park	Stamford Brook(District), Hammersmith(District)
Rayners Lane	Eastcote(Metropolitan; Picadilly), South Harrow(Picadilly), West Harrow(Metropolitan)
Redbridge	    Wanstead(Central), Gants Hill(Central)
Regent's Park	Baker Street(Bakerloo), Oxford Circus(Bakerloo)
Richmond	    Kew Gardens(District)
Rickmansworth	Chorleywood(Metropolitan), Moor Park(Metropolitan)
Roding Valley	Woodford(Central), Chigwell(Central)
Royal Oak 	Paddington(Circle; HammersmithCity), Westbourne Park(Circle; HammersmithCity)
Ruislip		Ruislip Manor(Picadilly; Metropolitan), Ickenham(Picadilly; Metropolitan)
Ruislip Gardens		South Ruislip(Central), West Ruislip(Central)
Ruislip Manor	Ruislip(Metropolitan; Picadilly), Eastcote(Metropolitan; Picadilly)
Russell Square	King's Cross St.Pancras(Picadilly), Holborn(Picadilly)
St.James's Park	Westminster(Circle; District), Victoria(Circle; District)
St.John's Wood	Swiss Cottage(Jubilee), Baker Street(Jubilee)
St.Paul's	    Chancery Lane(Central), Bank(Central)
Seven Sisters	Tottenham Hale(Victoria), Finsbury Park(Victoria)
Shepherd's Bush	Holland Park(Central), White City(Central)
Shepherd's Bush Market		Goldhawk Road(Circle; HammersmithCity), Wood Lane(Circle; HammersmithCity)
Sloane Square	South Kensington(Circle; District), Victoria(Circle; District)
Snaresbrook	    South Woodford(Central), Leytonstone(Central)
South Ealing	Northfields(Picadilly), Acton Town(Picadilly)
South Harrow	Sudbury Hill(Picadilly), Eastcote(Picadilly)
South Kensington	Gloucester Road(Picadilly; District; Circle), Sloane Square(District; Circle), Earl's Court(District; Picadilly)
South Kenton	Kenton(Bakerloo), North Wembley(Bakerloo)
South Ruislip	Ruislip Gardens(Central), Northolt(Central)
South Wimbledon	Colliers Wood(Northern), Morden(Northern)
South Woodford	Snaresbrook(Central), Woodford(Central)
Southfields	East Putney(District), Wimbledon Park(District)
Southgate	Arnos Grove(Picadilly), Oakwood(Picadilly)
Southwark	Waterloo(Jubilee), London Bridge(Jubilee)
Stamford Brook	Ravenscourt Park(District), Turnham Green(District)
Stanmore	Canons Park(Jubilee)
Stepney Green	Whitechapel(District; HammersmithCity), Mile End(District; HammersmithCity)
Stockwell	Oval(Northern), Clapham North(Northern), Brixton(Victoria), Vauxhall(Victoria)
Stonebridge Park	Wembley Central(Bakerloo), Harlesden(Bakerloo)
Stratford	West Ham(Jubilee), Leyton(Central), Mile End(Central)
Sudbury Hill	Sudbury Town(Picadilly), South Harrow(Picadilly)
Sudbury Town	Alperton(Picadilly), Sudbury Hill(Picadilly)
Swiss Cottage	Finchley Road(Jubilee), St.John's Wood(Jubilee)
Temple		Blackfriars(Circle; District), Embankment(Circle; District)
Theydon Bois	Debden(Central), Epping(Central)
Tooting Bec 	Balham(Northern), Tooting Broadway(Northern)
Tooting Broadway	Tooting Bec(Northern), Colliers Wood(Northern)
Tottenham Court Road	Oxford Circus(Central), Holborn(Central), Leicester Square(Northern), Goodge Street(Northern)
Tottenham Hale	Seven Sisters(Victoria), Blackhorse Road(Victoria)
Totteridge&Whetstone	High Barnet(Northern), Woodside Park(Northern)
Tower Hill	Monument(District; Circle), Aldgate(Circle), Aldgate East(District)
Tufnell Park	Archway(Northern), Kentish Town(Northern)
Turnham Green	Acton Town(Picadilly), Hammersmith(Picadilly), Stamford Brook(District), Gunnersbury(District), Chiswick Park(District)
Turnpike Lane	Manor House(Picadilly), Wood Green(Picadilly)
Upminster	Upminster Bridge(District)
Upminster Bridge	Upminster(District), Hornchurch(District)
Upney		Barking(District), Becontree(District)
Upton Park	East Ham(District; HammersmithCity), Plaistow(District; HammersmithCity)
Uxbridge	Hillingdon(Picadilly; Metropolitan)
Vauxhall	Pimlico(Victoria), Stockwell(Victoria)
Victoria	Pimlico(Victoria), Green Park(Victoria), Sloane Square(Circle; District), St.James's Park(Circle; District)
Walthamstow Central		Blackhorse Road(Victoria)
Wanstead	Redbridge(Central), Leytonstone(Central)
Warren Street	Euston(Northern; Victoria), Oxford Circus(Victoria), Goodge Street(Northern)
Warwick Avenue	Maida Vale(Bakerloo), Paddington(Bakerloo)
Waterloo	Embankment(Bakerloo), Elephant & Castle(Bakerloo; Northern), Westminster(Jubilee), Southwark(Jubilee), Kennington(Northern)
Watford		Croxley(Metropolitan)
Wembley Central	North Wembley(Bakerloo), Stonebridge Park(Bakerloo)
Wembley Park	Kingsbury(Jubilee), Neasden(Jubilee), Finchley Road(Metropolitan), Preston Road(Metropolitan)
West Acton	Ealing Broadway(Central), North Acton(Central)
West Brompton	Earl's Court(District), Fulham Broadway(District)
West Finchley	Finchley Central(Northern), Woodside Park(Northern)
West Ham 	Stratford(Jubilee), Canning Town(Jubilee), Bromley-by-Bow(District; HammersmithCity), Plaistow(District; HammersmithCity)
West Hampstead	Kilburn(Jubilee), Swiss Cottage(Jubilee)
West Harrow 	Rayners Lane(Metropolitan), Northwick Park(Metropolitan)
West Kensington	Barons Court(District), Earl's Court(District)
West Ruislip 	Ruislip Gardens(Central)
Westbourne Park	    Royal Oak(Circle; HammersmithCity), Ladbroke Grove(Circle; HammersmithCity)
Westminster	    Waterloo(Jubilee), Green Park(Jubilee), St.James's Park(Circle; District), Embankment(Circle; District)
White City	Shepherd's Bush(Central), East Acton(Central)
Whitechapel	Aldgate East(District; HammersmithCity), Stepney Green(HammersmithCity; District)
Willesden Green		Dollis Hill(Jubilee), Kilburn(Jubilee)
Willesden Junction		Kensal Green(Bakerloo), Harlesden(Bakerloo)
Wimbledon	Wimbledon Park(District)
Wimbledon Park	Wimbledon(District), Southfields(District)
Wood Green	Bounds Green(Picadilly), Turnpike Lane(Picadilly)
Wood Lane	Shepherd's Bush Market(Circle; HammersmithCity), Latimer Road(Circle; HammersmithCity)
Woodford	Buckhurst Hill(Central), Roding Valley(Central), South Woodford(Central)
Woodside Park	Totteridge&Whetstone(Northern), West Finchley(Northern)